########
#...B..#
#..@...#
#......#
########
